########
#  x   #
#  $   #
#  @   #
#  $   #
#  x   #
########
