  ##########
  #D       #
###   $ $  #
#    S $   #
# @  ###  x#
#    $ $  x#
#    ###  x#
#    S     #
#    D     #
############
