########
#  x   #
#      #
#      #
#  @   #
#      #
########
