  ########
  #      #
  # $xxx #
  # $ $  #
###  $ ##
#   $  #
# @ $  #
#      #
########
